{
  "0": [
    "        H          H        ",
    "        H----------H        ",
    "        H          H        ",
    "   H#####          #####H   ",
    "   H    #    &     #    H   ",
    "############################",
    "",
    ""
  ]
}